"filename", "language", "pip requirements", "Python", "comment", "blank", "total"
"c:\Users\adams\Documents\GitHub\Masters-Project-BioPhysics\Surface model\Make_movie.py", "Python", 0, 137, 19, 44, 200
"c:\Users\adams\Documents\GitHub\Masters-Project-BioPhysics\Surface model\Testing_ideas.py", "Python", 0, 61, 12, 18, 91
"c:\Users\adams\Documents\GitHub\Masters-Project-BioPhysics\Surface model\Two_D_constants.py", "Python", 0, 184, 24, 35, 243
"c:\Users\adams\Documents\GitHub\Masters-Project-BioPhysics\Surface model\Two_D_functions.py", "Python", 0, 594, 29, 157, 780
"c:\Users\adams\Documents\GitHub\Masters-Project-BioPhysics\Surface model\Two_D_simulation_function.py", "Python", 0, 518, 11, 90, 619
"c:\Users\adams\Documents\GitHub\Masters-Project-BioPhysics\Surface model\requirements.txt", "pip requirements", 17, 0, 0, 1, 18
"c:\Users\adams\Documents\GitHub\Masters-Project-BioPhysics\Surface model\surface_sim.py", "Python", 0, 195, 4, 39, 238
"c:\Users\adams\Documents\GitHub\Masters-Project-BioPhysics\Surface model\testing_functions.py", "Python", 0, 736, 70, 187, 993
"c:\Users\adams\Documents\GitHub\Masters-Project-BioPhysics\Surface model\two_d_continues_integration.py", "Python", 0, 72, 83, 18, 173
"c:\Users\adams\Documents\GitHub\Masters-Project-BioPhysics\Surface model\two_d_data_processing.py", "Python", 0, 131, 8, 36, 175
"c:\Users\adams\Documents\GitHub\Masters-Project-BioPhysics\Surface model\two_d_plot_data.py", "Python", 0, 93, 4, 21, 118
"Total", "-", 17, 2721, 264, 646, 3648